1111111111111111111111111111111111111111
1111111111111111111111111111111111111111
1111111111111111111111111111111111111111
1111111111111111111111111111111111141111
1111121121111111111111111111111111101111
1111111101111111111111111111111111101111
1111111101111111111111111111111111101111
11111111011111111TT11011SS11111111101111
1111111100000000000000000000000111101111
1111111101111111111110111111111111101111
1111111101111111111110111111111111101111
1111111101111111111110111111111111101111
1111111101111111111000001111111111101111
1111111101111111111000001111111111101111
1111111101111111111000001111111111101111
1111111100000000000000001111111111101111
1111111111111111111000001111111111101111
1111111111111111111000001111111131101111
1111111111111111111110011111111101101111
1111111111111111111110011111111101101111
1111111111111111111110000000000000001111
1111111111111111111111111111111111111111
1111111111111111111111111111111111111111
1111111111111111111111111111111111111111
